111111111111111
100000022220001
101010101010101
100000000000001
101010101010101
100000000000001
101010101010101
100000000000001
101010101010101
100000000000001
101010101010101
100000000000001
101010101010101
100000000000001
111111111111111
