111111111111111
100022222220001
101212121212101
100202222222201
121210121212121
120002222202221
121212121212121
122222220022221
121210121212121
122220022200221
121212121212121
122222022222221
101212121212101
100022222220001
111111111111111
