111111111111111
100000022220001
101010101010101
100000022222001
101010101012101
100000222222001
101010121212101
100000222222201
101010121212101
100000022222001
101010101010101
100000000000001
101010101010101
100000000000001
111111111111111
