111111111111111
130000000000001
101010101010101
100000000000001
101010101010101
100000000000001
101010101010101
100000000000001
101010101010101
100000000000001
101010101010101
100000000000001
101010101010101
100000000000001
111111111111111
